NO ./textures/simonkraft/wet_sponge.xpm
SO ./textures/simonkraft/wet_sponge.xpm
WE ./textures/simonkraft/wet_sponge.xpm
EA ./textures/simonkraft/wet_sponge.xpm

F 220,100,0
C 225,30,0

        1111111111111111111111111
        1010000000110000000000001
        1011000001110000000000001
        1001000000000000000000001
111111111011D1D11110000000000001
10000000001100S001110111111111111
11110111101111011100000010001
11110111111111111101010010001
110000001101 1011100000010001
10001D100001 1000110000010001
100001000001 10001101010010101
110000011101101111101111101111
11110111 1110101 101111010101
11111111 1111111 111111111111
